Name,Math,Science,English,History,Total,Average
Aman,78,82,75,70,305,76.25
Ben,88,90,92,85,355,88.75
Chirag,65,60,70,68,263,65.75
Divya,95,92,96,94,377,94.25
Esha,50,55,58,52,215,53.75
Farhan,72,75,80,78,305,76.25
Gita,60,62,65,60,247,61.75
Harsh,85,80,82,86,333,83.25
Ishita,90,88,91,89,358,89.5
Jay,45,50,48,52,195,48.75
